Act: ActHeader Scenes
Acts: Act | Act Acts
ActHeader: ACT_ROMAN COLON Comment EndSymbol
Adjective: POSITIVE_ADJ | NEUTRAL_ADJ | NEGATIVE_ADJ
BinaryOperator: THE_DIFFERENCE_BETWEEN | THE_PRODUCT_OF | THE_QUOTIENT_BETWEEN |
                THE_REMAINDER_OF_THE_QUOTIENT_BETWEEN | THE_SUM_OF
CharacterDeclaration: CHARACTER COMMA Comment EndSymbol 
CharacterDeclarationList: CharacterDeclaration |
                          CharacterDeclaration CharacterDeclarationList
CharacterList: CHARACTER AND CHARACTER | CHARACTER COMMA CharacterList
Comment: String
Comparative: NegativeComparative | PositiveComparative
Comparison: NOT NonnegatedComparison | NonnegatedComparison
Conditional: IF_SO | IF_NOT
Constant: ARTICLE UnarticulatedConstant | FIRST_PERSON_POSSESSIVE UnarticulatedConstant |
          SECOND_PERSON_POSSESSIVE UnarticulatedConstant |
          THIRD_PERSON_POSSESSIVE UnarticulatedConstant | NOTHING
EndSymbol: QuestionSymbol | StatementSymbol 
EnterExit: LEFT_BRACKET ENTER CHARACTER RIGHT_BRACKET |
           LEFT_BRACKET ENTER CharacterList RIGHT_BRACKET |
           LEFT_BRACKET EXIT CHARACTER RIGHT_BRACKET | 
           LEFT_BRACKET EXEUNT CharacterList RIGHT_BRACKET | 
           LEFT_BRACKET EXEUNT RIGHT_BRACKET 
Equality: AS Adjective AS
Inequality: Comparative THAN
InOut: OpenYour HEART StatementSymbol | SPEAK SECOND_PERSON_POSSESSIVE MIND StatementSymbol |
       LISTEN_TO SECOND_PERSON_POSSESSIVE HEART StatementSymbol |
       OpenYour MIND StatementSymbol
Jump: JumpPhrase ACT_ROMAN StatementSymbol | JumpPhrase SCENE_ROMAN StatementSymbol
JumpPhrase: JumpPhraseBeginning JumpPhraseEnd
JumpPhraseBeginning: LET_US | WE_MUST | WE_SHALL
JumpPhraseEnd: PROCEED_TO | RETURN_TO
Line: CHARACTER COLON SentenceList
NegativeComparative: NEGATIVE_COMPARATIVE | MORE NEGATIVE_ADJECTIVE | LESS POSITIVE_ADJECTIVE 
NegativeConstant: NegativeNoun | NEGATIVE_ADJECTIVE NegativeConstant | 
                  NEUTRAL_ADJECTIVE NegativeConstant
NegativeNoun: NEGATIVE_NOUN
NonnegatedComparison: Equality | Inequality
OpenYour: OPEN SECOND_PERSON_POSSESSIVE
Play: Title CharacterDeclarationList Acts
PositiveComparative: POSITIVE_COMPARATIVE | MORE POSITIVE_ADJECTIVE | LESS NEGATIVE_ADJECTIVE
PositiveConstant: PositiveNoun | POSITIVE_ADJECTIVE PositiveConstant | 
                  NEUTRAL_ADJECTIVE PositiveConstant
PositiveNoun: NEUTRAL_NOUN | POSITIVE_NOUN
Pronoun: FIRST_PERSON | FIRST_PERSON_REFLEXIVE | SECOND_PERSON| SECOND_PERSON_REFLEXIVE
Question: BE Value Comparison Value QuestionSymbol
QuestionSymbol: QUESTION_MARK
Recall: RECALL String StatementSymbol
Remember: REMEMBER Value StatementSymbol
Scene: SceneHeader SceneContents
Scenes: Scene | Scene Scenes
SceneContents: EnterExit | Line | SceneContents EnterExit | SceneContents Line
SceneHeader: SCENE_ROMAN COLON Comment EndSymbol
Sentence: UnconditionalSentence | Conditional COMMA UnconditionalSentence 
SentenceList: Sentence | SentenceList Sentence
StartSymbol: Play
Statement: SECOND_PERSON BE Constant StatementSymbol | 
           SECOND_PERSON UnarticulatedConstant StatementSymbol |
           SECOND_PERSON BE Equality Value StatementSymbol
StatementSymbol: EXCLAMATION_MARK | PERIOD
String: StringSymbol | String StringSymbol
StringSymbol: ARTICLE | BE | CHARACTER | FIRST_PERSON | FIRST_PERSON_POSSESSIVE |
              FIRST_PERSON_REFLEXIVE | NEGATIVE_ADJECTIVE | NEGATIVE_COMPARATIVE |
              NEGATIVE_NOUN | NEUTRAL_ADJECTIVE | NEUTRAL_NOUN | NOTHING | 
              POSITIVE_ADJECTIVE | POSITIVE_COMPARATIVE | POSITIVE_NOUN | SECOND_PERSON |
              SECOND_PERSON_POSSESSIVE | SECOND_PERSON_REFLEXIVE | THIRD_PERSON_POSSESSIVE |
              COMMA AND | AS | ENTER | EXEUNT | EXIT | HEART | IF_NOT | IF_SO | LESS | 
              LET_US| LISTEN_TO | MIND | MORE | NOT | OPEN | PROCEED_TO | RECALL |
              REMEMBER | RETURN_TO | SPEAK | THAN | THE_CUBE_OF | THE_DIFFERENCE_BETWEEN |
              THE_FACTORIAL_OF | THE_PRODUCT_OF | THE_QUOTIENT_BETWEEN | 
              THE_REMAINDER_OF_THE_QUOTIENT_BETWEEN | THE_SQUARE_OF | THE_SQUARE_ROOT_OF |
              THE_SUM_OF | TWICE | WE_MUST | WE_SHALL | ACT_ROMAN | SCENE_ROMAN |
              ROMAN_NUMBER | NONMATCH
Title: String EndSymbol
UnarticulatedConstant: PositiveConstant | NegativeConstant
UnaryOperator: THE_CUBE_OF | THE_FACTORIAL_OF | THE_SQUARE_OF | THE_SQUARE_ROOT_OF | TWICE
UnconditionalSentence: InOut | Jump | Question | Recall | Remember | Statement 
Value: CHARACTER | Constant | Pronoun | BinaryOperator Value AND Value | UnaryOperator Value